1111111111111111111111111
10000E0000000000000000111
10P000C010000000000000111
100000000001000E000000111
1000E00000010000000000111
1C110000000E000C000000111
1C11000C0C0C0000000000111
1111111111111111111111111