111111111
100000001
10P000C01
100000001
1000E0001
111111111