1111111111111
10000E0000001
100V0E0000001
10000E000V001
10000E0000001
10P000C010001
1111111111111