1111111111111111111111111
10000E00000011E0000000111
10P000C010000000100000111
10000000000100VE000000111
1000E000E0010000000000111
1C110000100E000C000000111
1C11000C0C0C0000000V00111
1111111111111111111111111