111111111111111111111111111111111
100000000000000000000000000000001
1000000000C000000000000000CC00001
100000010000000000000000000000001
100000010000000000000000000000001
100000000000000000000000000000001
100000000000000000000000000000001
10000000000000000000000000C000001
100000010000000000000001000000001
100000000000000C00000001000000001
1P00000000000000E0000001000000001
100000000000000000000001000010001
10000000000000V000000000000010001
100000000000000000000000000010001
1000000V0000000000000000000010001
100000000000000000000000000000001
100000000000000000000000000000001
111111111111111111111111111111111